ARE	AA R
ARE(2)	ER
BACKWARD	B AE K W ER D
COME	K AH M
FORWARD	F AO R W ER D
GO	G OW
GOODBYE	G UH D B AY
HEY	HH EY
IS	IH Z
LEFT	L EH F T
NAME?	N EY M
RIGHT	R AY T
STOP	S T AA P
TEST	T EH S T
WHAT	W AH T
WHAT(2)	HH W AH T
WHERE	W EH R
WHERE(2)	HH W EH R
WHO	HH UW
YOU?	Y UW
YOUR	Y AO R
YOUR(2)	Y UH R
